fpsmap1
size 16 16
row 1 1 1 1 1 1 1 1 1 1 1 1 1 1 1 1
row 1 0 0 0 0 0 0 0 0 0 0 0 0 0 0 1
row 1 0 0 0 0 0 0 0 2 0 2 2 2 2 0 1
row 1 0 0 0 0 0 0 0 2 0 0 0 0 2 0 1
row 1 0 0 0 0 0 0 0 2 0 2 0 0 2 0 1
row 1 0 0 0 0 3 0 0 2 0 2 2 2 2 0 1
row 1 0 0 0 0 0 0 0 2 0 0 0 0 0 0 1
row 1 0 0 0 0 0 0 0 2 0 0 0 0 0 0 1
row 1 0 0 0 0 0 0 0 0 0 0 0 0 0 0 1
row 1 0 0 0 0 0 0 0 2 0 0 0 0 0 0 1
row 1 0 0 0 0 0 0 0 2 0 0 0 0 3 0 1
row 1 0 0 0 0 3 0 0 2 0 0 0 0 0 0 1
row 1 0 0 0 0 0 3 0 2 0 0 0 0 0 0 1
row 1 0 0 0 0 0 0 0 2 0 0 0 0 0 0 1
row 1 0 0 0 0 0 0 0 0 0 0 0 0 0 0 1
row 1 1 1 1 1 1 1 1 1 1 1 1 1 1 1 1
spawn 3 8 0.000000
